Galvani
0,0,0,3,3,2,0,0,0,3,3,3,3,3,0,2,3,3,3,3,3,1,0,
0,3,3,0,0,3,1,3,3,0,0,0,3,1,3,3,1,0,3,3,0,3,0,
3,0,0,3,3,0,0,3,3,3,1,1,0,0,1,3,3,3,0,0,3,3,3,
3,1,3,0,0,3,3,0,0,3,3,0,3,3,0,0,3,3,3,0,3,3,3,
3,0,3,0,3,0,0,1,3,0,0,3,1,0,1,3,0,1,3,0,0,0,3,
3,0,3,0,3,0,3,0,0,3,3,8,3,3,0,0,3,0,3,0,0,0,3,
3,0,3,1,3,0,3,1,3,0,0,0,0,0,3,0,3,0,3,0,0,1,3,
1,0,3,0,3,0,3,0,3,3,0,9,0,3,3,0,3,0,3,0,1,3,3,
3,0,3,0,3,0,3,3,0,0,1,3,1,0,1,3,3,0,3,1,0,0,3,
3,2,3,0,3,3,1,0,3,3,1,0,0,3,3,0,0,3,3,0,3,0,3,
3,1,3,0,0,3,3,3,0,0,3,3,0,1,0,3,3,0,0,3,3,2,3,
3,3,0,3,3,0,0,1,3,0,0,1,3,3,3,0,0,0,0,3,3,0,3,
0,0,3,0,0,0,3,3,0,0,3,3,0,0,0,0,0,3,3,0,0,3,3,
0,0,0,0,0,0,0,0,3,3,1,0,1,3,1,3,1,3,3,3,3,0,0,